0000000000000
0R00000000000
000000R000000
0000000000R00
0R00000000000
000000R000000
0R00000000000
0000000000R00
0000000000000